{
  "background": [
      1465, 1465, 1465, 1465, 1465, 1465, 1465, 1465, 1465, 1465, 1465, 1465, 1465, 1465, 1465, 1465, 1465, 1465, 1465, 1465, 1465, 1465, 1465, 1465, 1465, 1465, 1465, 1465, 1465, 1465,
      1465, 1465, 1465, 1465, 1465, 1465, 1465, 1465, 1465, 1465, 11, 12, 13, 14, 1465, 1465, 1465, 1465, 1465, 1465, 1465, 1465, 1465, 1465, 1465, 1465, 1465, 1465, 1465, 1465,
      1465, 1465, 1465, 1465, 1465, 1465, 1465, 1465, 1465, 1465, 29, 30, 31, 32, 7, 8, 9, 10, 1465, 1465, 1465, 1465, 1465, 47, 48, 49, 50, 1465, 1465, 1465,
      1465, 1465, 1465, 1465, 1465, 87, 88, 89, 1465, 1465, 1465, 1465, 1465, 24, 25, 26, 27, 83, 84, 85, 86, 1465, 1465, 65, 66, 67, 68, 1465, 1465, 1465,
      1465, 1465, 1465, 1465, 1465, 105, 106, 299, 300, 301, 302, 303, 51, 52, 53, 44, 45, 101, 102, 103, 104, 1465, 1465, 1465, 1465, 1465, 1465, 1465, 1465, 1465,
      1465, 1465, 1465, 1465, 1465, 1465, 1465, 317, 318, 319, 320, 321, 69, 70, 71, 1465, 1465, 1465, 1465, 1465, 1465, 1465, 1465, 1465, 1465, 1465, 1465, 1465, 1465, 1465,
      1465, 1465, 1465, 1465, 1465, 1465, 1465, 1465, 1465, 1465, 1465, 1465, 1465, 1465, 1465, 1465, 1465, 1465, 1465, 1465, 1465, 1465, 1465, 1465, 1465, 1465, 1465, 1465, 1465, 1465,
      1465, 1465, 1465, 1465, 1465, 1465, 1465, 1465, 1465, 1465, 1465, 1465, 1465, 1465, 1465, 1465, 1465, 1465, 1465, 1465, 1465, 1465, 1465, 1465, 1465, 1465, 1465, 1465, 1465, 1465,
      1465, 1465, 1465, 224, 225, 1465, 1465, 1465, 1465, 1465, 1465, 1465, 1465, 1465, 1465, 1465, 1465, 1465, 1465, 1465, 1465, 1465, 1465, 1465, 1465, 1465, 1465, 218, 219, 1465,
      1465, 1465, 1465, 242, 243, 1465, 1465, 238, 239, 1465, 1465, 1465, 1465, 1465, 1465, 1465, 1465, 1465, 1465, 1465, 1465, 1465, 1465, 1465, 1465, 1465, 1465, 236, 237, 1465,
      1465, 1465, 1465, 260, 261, 1465, 1465, 256, 257, 1465, 1465, 1465, 1465, 1465, 1465, 1465, 1465, 1465, 1465, 1465, 1465, 1465, 1465, 1465, 1465, 1465, 1465, 254, 255, 1465,
      61, 96, 61, 278, 279, 97, 61, 274, 275, 1465, 1465, 1465, 1465, 1465, 1465, 1465, 1465, 1465, 1465, 1465, 1465, 1465, 1465, 1465, 1465, 98, 111, 61, 273, 111,
      1465, 1465, 1465, 1465, 1465, 1465, 1465, 1465, 1465, 1465, 1465, 1465, 1465, 1465, 346, 347, 350, 1465, 1465, 1465, 1465, 1465, 1465, 1465, 1465, 1465, 1465, 1465, 1465, 1465,
      1465, 1465, 1465, 1465, 1465, 1465, 1465, 1465, 1465, 1465, 1465, 1465, 1465, 1465, 1465, 1465, 1465, 240, 241, 1465, 1465, 1465, 1465, 1465, 1465, 1465, 1465, 1465, 1465, 1465,
      1465, 1465, 1465, 1465, 1465, 1465, 1465, 1465, 1465, 1465, 1465, 1465, 1465, 1465, 1465, 1465, 1465, 258, 259, 1465, 1465, 1465, 1465, 1465, 1465, 1465, 1465, 1465, 1465, 1465,
      1465, 1465, 1465, 1465, 1465, 1465, 1465, 1465, 1465, 93, 1465, 1465, 1465, 1465, 1465, 1465, 1465, 276, 277, 1465, 78, 1465, 78, 116, 93, 111, 1465, 1465, 1465, 1465,
      1465, 1465, 1465, 1465, 1465, 1465, 1465, 1465, 1465, 1465, 1465, 1465, 1465, 1465, 1465, 1465, 1465, 1465, 1465, 1465, 1465, 1465, 1465, 1465, 1465, 1465, 1465, 1465, 1465, 1465,
      1465, 1465, 1465, 1465, 1465, 1465, 1465, 1465, 1465, 1465, 1465, 1465, 1465, 1465, 1465, 1465, 1465, 1465, 1465, 1465, 1465, 1465, 1465, 1465, 1465, 1465, 1465, 1465, 1465, 1465,
      1465, 1465, 1465, 1465, 1465, 1465, 1465, 1465, 1465, 1465, 1465, 1465, 1465, 1465, 1465, 1465, 1465, 1465, 1465, 1465, 1465, 1465, 1465, 1465, 1465, 1465, 1465, 1465, 1465, 1465,
      1465, 1465, 1465, 1465, 1465, 1465, 1465, 1465, 1465, 1465, 1465, 1465, 1465, 1465, 1465, 1465, 1465, 1465, 1465, 1465, 1465, 1465, 1465, 1465, 1465, 1465, 1465, 1465, 1465, 1465
  ],
  "ground": [
      0, 0, 0, 0, 0, 0, 0, 0, 0, 0, 0, 0, 0, 0, 0, 0, 0, 0, 0, 0, 0, 0, 0, 0, 0, 0, 0, 0, 0, 0,
      0, 0, 0, 0, 0, 0, 0, 0, 0, 0, 0, 0, 0, 0, 0, 0, 0, 0, 0, 0, 0, 0, 0, 0, 0, 0, 0, 0, 0, 0,
      0, 0, 0, 0, 0, 0, 0, 0, 0, 0, 0, 0, 0, 0, 0, 0, 0, 0, 0, 0, 0, 0, 0, 0, 0, 0, 0, 0, 0, 0,
      0, 0, 0, 0, 0, 0, 0, 0, 0, 0, 0, 0, 0, 0, 0, 0, 0, 0, 0, 0, 0, 0, 0, 0, 0, 0, 0, 0, 0, 0,
      0, 0, 0, 0, 0, 0, 0, 0, 0, 0, 0, 0, 0, 0, 0, 0, 0, 0, 0, 0, 0, 0, 0, 0, 0, 0, 0, 0, 0, 0,
      0, 0, 0, 0, 0, 0, 0, 0, 0, 0, 0, 0, 0, 0, 0, 0, 0, 0, 0, 0, 0, 0, 0, 0, 0, 0, 0, 0, 0, 0,
      0, 0, 0, 0, 0, 0, 0, 0, 0, 0, 0, 0, 0, 0, 0, 0, 0, 0, 0, 0, 0, 0, 0, 0, 0, 0, 0, 0, 0, 0,
      0, 0, 0, 0, 0, 0, 0, 0, 0, 0, 0, 0, 0, 0, 0, 0, 0, 0, 0, 0, 0, 0, 0, 0, 0, 0, 0, 0, 0, 0,
      0, 0, 0, 0, 0, 0, 0, 0, 0, 0, 0, 0, 0, 0, 0, 0, 0, 0, 0, 0, 0, 0, 0, 0, 0, 0, 0, 0, 0, 0,
      0, 0, 0, 0, 0, 0, 0, 0, 0, 0, 0, 0, 0, 0, 0, 0, 0, 0, 0, 0, 0, 0, 0, 0, 0, 0, 0, 0, 0, 0,
      0, 0, 0, 0, 0, 0, 0, 0, 0, 0, 0, 0, 0, 0, 0, 0, 0, 0, 0, 0, 0, 0, 0, 0, 0, 0, 0, 0, 0, 0,
      0, 0, 0, 0, 0, 0, 0, 0, 0, 0, 0, 0, 0, 0, 0, 0, 0, 0, 0, 0, 0, 0, 0, 0, 0, 0, 0, 0, 0, 0,
      345, 345, 346, 346, 113, 346, 346, 346, 346, 171, 0, 0, 0, 0, 0, 0, 0, 0, 0, 0, 0, 0, 0, 0, 0, 164, 114, 114, 114, 114,
      0, 0, 0, 0, 0, 0, 0, 0, 0, 189, 0, 0, 0, 0, 0, 0, 0, 0, 0, 0, 0, 0, 0, 0, 0, 182, 0, 0, 0, 0,
      0, 0, 0, 0, 0, 0, 0, 0, 0, 207, 0, 0, 0, 0, 0, 0, 0, 0, 0, 0, 0, 0, 0, 0, 0, 200, 0, 0, 0, 0,
      0, 0, 0, 0, 0, 0, 0, 0, 0, 95, 96, 0, 0, 0, 0, 0, 0, 0, 0, 0, 0, 0, 0, 0, 0, 0, 0, 0, 0, 0,
      0, 0, 0, 0, 0, 0, 0, 0, 0, 114, 114, 114, 114, 114, 346, 346, 346, 346, 345, 345, 345, 345, 347, 347, 115, 130, 0, 0, 0, 0,
      0, 0, 0, 0, 0, 0, 0, 0, 0, 0, 0, 0, 0, 0, 0, 0, 0, 0, 0, 0, 0, 0, 0, 0, 0, 0, 0, 0, 0, 0,
      0, 0, 0, 0, 0, 0, 0, 0, 0, 0, 0, 0, 0, 0, 0, 0, 0, 0, 0, 0, 0, 0, 0, 0, 0, 0, 0, 0, 0, 0,
      0, 0, 0, 0, 0, 0, 0, 0, 0, 0, 0, 0, 0, 0, 0, 0, 0, 0, 0, 0, 0, 0, 0, 0, 0, 0, 0, 0, 0, 0
  ]
}